shadoon - The Planet of Shadoon

Parent: shadoon
rookie
bergen
bakii - Ba'kii Kum
basin
gaia - V'rda Vil
sapphire
rhombus

Parent: shadoon
va - The Venture Alliance
hpd - The Human Preservation Department
aha - The Association of Human Advancement
aob - The Amity of Balance

omni - Omni Gilders
fs - The First Scholars
lmh - The Last Minute Heroes

teak - Ms. Teak's Steaks
icecream - Frosty Arnold's Ice Cream Stand
plants - Talatu Lips' Botantical Garden
tara-cc - Tara's Sandwich Shop
hermit - Hermit's Pub (bergen)
tophat - Bergen Hatmaker
bergen-mine - The Bergen Mine
brewery - The Ba'kii Kum Brewery
bazaar - The Baki Bazaar Union
... (basin)
pond - The Pond Slums Traders
zirvitar - Zir'vitar Power Plant (basin)
... (sapphire)
booster - Rhombus Booster Shop
chest - Rhombus Chest Detector Shop
arena - The Rhombus Arena

<city>-equipment
<city>-traders



tora - The Continent of Tora

Parent: tora
brigantia - The Nation of Brigantia
korzojeno - The Nation of Korzojeno

sinkholm
nomerea
toras-inn
buronia
corine-inn
corine - The Corine Plateau Traders
gencorin
domarkor
helnovien
ferrolholm
hamsol
retisa - Port Retisa
pakonia - Pakonia (Uchiko racing)

tara-vel - Tara's Shop at Gencorin
<city>-equipment
<city>-traders (Only if there's a trading scene there)
<city>-inn



arcane - The Arcane Lab
genesis - Autumn's Genesis